#LIST
Accessing Medidata Balance	accessingBalance.htm	List_of_Show_Me_Videos.htm
Adding a Study Arm	addingStudyArms	List_of_Show_Me_Videos.htm
Adding Randomization Factors		addingRandomizationFactors.htm	List_of_Show_Me_Videos.htm
Assigning Sites to a Supply Plan	assigningSites.htm				List_of_Show_Me_Videos.htm
Balancing Randomization				balancingRandomization.htm		List_of_Show_Me_Videos.htm
Second Best Probability				secondBestProbability.htm		List_of_Show_Me_Videos.htm
Editing a Live Study				editLiveDesign.htm				List_of_Show_Me_Videos.htm
Setting Up a Simulation	settingUpASimulation.htm	List_of_Show_Me_Videos.htm
Executing a Simulation	executingASimulation.htm	List_of_Show_Me_Videos.htm
Viewing the Detailed Results	detailedResultsPage.htm	List_of_Show_Me_Videos.htm
Means and Standard Deviations	meansStandardDeviation.htm	List_of_Show_Me_Videos.htm
Minima	minima.htm	List_of_Show_Me_Videos.htm
Runs Out of Balance	runsOutOfBalance.htm	List_of_Show_Me_Videos.htm
Viewing Simulation Analysis	simulationAnalysisPage.htm	List_of_Show_Me_Videos.htm
Treatment Design	treatmentDesign.htm	List_of_Show_Me_Videos.htm
Treatment Schedule	treatmentSchedule.htm	List_of_Show_Me_Videos.htm
Site List	siteListPage.htm	List_of_Show_Me_Videos.htm
Unblinding a Subject	subjectUnblinding.htm	List_of_Show_Me_Videos.htm
Inventory Item List	inventoryListPage.htm	List_of_Show_Me_Videos.htm
Inviting Users to Medidata Balance	invitingUsers.htm	List_of_Show_Me_Videos.htm
Unblinding an Inventory Item	unblindingInventoryItems.htm	List_of_Show_Me_Videos.htm
Shipment List	shipmentListPage.htm	List_of_Show_Me_Videos.htm
Inventory Batch List	inventoryBatchListPage.htm	List_of_Show_Me_Videos.htm
Managing an Article Type	managingArticleTypes.htm	List_of_Show_Me_Videos.htm
Managing a Treatment	managingTreatments.htm	List_of_Show_Me_Videos.htm
Create and Manage a Supply Plan	supplyPlan.htm	List_of_Show_Me_Videos.htm
Buffer-Only Supply Plans	bufferOnly.htm	List_of_Show_Me_Videos.htm
Predictive-Only Supply Plans	predictiveOnly.htm	List_of_Show_Me_Videos.htm
Predictive-And-Buffer Supply Plans	predictiveAndBuffer.htm	List_of_Show_Me_Videos.htm
Properties	propertiesPage.htm	List_of_Show_Me_Videos.htm
Using the Search Filter	searchFilter.htm	List_of_Show_Me_Videos.htm
#CONTEXTUAL
design and management services.			accessingBalance.htm			Working_in_Medidata_Balance.htm
have access through iMedidata, as well.	invitingUsers.htm				Creating_a_New_Balance_Study.htm
population assigned to each arm.		addingStudyArms.htm				Study_Arms.htm
need to be defined for a factor.		addingRandomizationFactors.htm	Randomization_Factors.htm
the default is 15%.						secondBestProbability.htm		Setting_the_Second_Best_Probability.htm
